60
20
32	32	32	32	32	32	32	32	32	32	32	32	32	32	32	32	32	32	32	32	32	32	32	32	32	32	32	32	32	32	32	32	32	32	32	32	32	32	32	32	32	32	34	32	32	32	32	32	32	32	32	32	32	32	32	32	32	32	32	32
32	65	0	40	61	40	32	32	40	40	40	40	40	40	40	40	40	40	40	40	40	40	40	40	40	40	40	40	40	40	40	40	40	40	40	41	42	42	42	42	42	43	34	33	40	40	40	40	40	40	29	69	69	69	69	69	60	40	40	40
32	0	0	40	40	40	40	32	32	40	40	40	40	40	40	40	40	60	40	40	40	40	40	40	40	40	40	40	40	40	40	60	40	40	40	67	66	66	66	66	66	44	34	40	41	42	42	42	43	40	69	69	69	69	69	69	40	40	40	40
32	0	0	40	40	40	40	40	32	32	40	40	40	40	40	40	40	40	40	40	40	40	40	40	40	40	40	40	40	40	40	40	40	40	40	67	66	66	66	66	66	44	34	40	67	66	66	66	44	40	69	69	69	69	69	69	40	55	59	59
32	69	69	40	40	40	40	40	40	32	32	40	40	40	40	40	40	40	40	40	40	40	40	40	40	40	40	40	40	40	40	40	40	40	40	67	66	66	66	66	66	44	34	40	67	66	66	66	44	60	69	69	69	69	69	69	40	54	34	34
32	40	40	40	40	40	40	40	40	60	32	32	32	40	40	40	40	40	40	40	40	40	40	40	40	40	40	40	40	40	40	40	40	40	40	67	66	66	66	66	66	44	34	33	67	66	66	66	44	40	69	69	69	69	69	69	40	54	34	34
32	40	40	40	40	40	40	40	40	40	40	40	32	32	32	40	40	40	40	40	30	0	40	40	40	40	40	40	40	40	40	40	40	40	40	47	46	46	46	46	46	45	25	48	66	66	66	66	44	40	69	69	69	69	69	69	40	54	34	34
32	40	40	40	40	40	40	40	40	40	40	40	40	32	32	32	32	32	32	32	0	0	32	32	32	32	32	40	40	40	40	40	40	40	40	40	40	40	40	40	40	40	35	40	47	46	46	46	45	40	69	69	69	69	69	69	60	54	34	34
32	40	40	40	40	40	40	40	40	40	40	40	40	32	32	32	32	32	32	32	0	0	32	32	32	32	32	32	32	32	32	32	32	32	32	32	32	32	32	32	32	32	36	64	64	30	0	33	33	33	69	69	69	69	69	69	40	54	34	34
32	40	40	40	40	40	40	40	40	40	40	40	40	32	32	32	32	32	32	32	0	0	32	32	32	32	32	32	32	32	32	32	32	32	32	32	32	32	32	32	32	32	36	64	33	0	0	33	33	61	69	69	69	69	69	69	40	54	34	34
32	40	40	40	40	40	40	40	40	40	40	40	40	32	32	41	42	42	42	42	42	42	42	42	42	42	42	42	42	42	42	42	42	42	42	42	42	42	42	42	43	40	36	40	40	0	0	63	62	40	46	46	46	46	46	46	46	54	34	34
32	40	40	40	40	40	40	40	40	40	40	40	40	32	32	67	66	66	66	66	66	66	66	66	66	66	66	66	66	66	66	66	66	66	66	66	66	66	66	66	44	40	37	40	40	0	0	40	40	40	40	40	40	40	40	40	40	54	34	34
32	40	40	40	40	40	40	40	40	40	40	31	0	41	42	66	66	66	66	66	66	66	66	66	66	66	66	66	66	66	66	66	66	66	66	66	66	66	66	66	66	54	34	50	51	40	40	40	40	40	40	40	40	40	40	65	0	54	34	34
32	40	40	40	40	40	40	40	40	40	40	0	0	67	66	66	66	66	66	66	66	66	66	66	66	66	66	66	66	66	56	57	57	57	57	57	57	57	57	57	57	58	34	34	52	50	50	50	51	40	40	40	40	40	40	0	0	54	34	34
32	40	40	40	40	40	40	40	40	40	40	0	0	47	46	66	66	66	66	66	66	66	66	66	66	66	66	66	66	66	21	34	34	34	34	34	34	34	34	34	34	34	34	34	34	34	34	34	52	50	50	50	51	40	40	0	0	54	34	34
32	40	40	40	40	40	40	40	40	40	40	0	0	65	0	67	66	66	66	66	66	66	66	66	66	66	66	66	66	66	21	34	28	27	27	27	27	27	27	27	27	27	27	27	27	27	27	27	27	27	27	27	53	40	40	69	69	54	34	34
32	40	40	40	40	40	40	40	40	40	40	32	32	0	0	47	46	46	46	46	46	46	46	46	46	46	46	46	46	66	21	34	22	23	23	23	23	23	23	23	23	23	23	23	23	23	23	23	23	23	23	23	53	49	49	50	50	58	34	34
32	40	40	40	40	40	40	40	40	40	40	32	32	0	0	40	40	40	40	40	40	40	40	40	40	60	40	40	40	67	21	34	22	23	23	23	23	23	23	23	23	23	23	23	23	23	23	23	23	23	23	23	23	49	49	23	23	23	23	23
32	60	40	40	40	40	40	40	40	40	40	32	32	69	69	61	61	61	61	61	61	61	61	61	61	61	61	61	61	67	21	34	22	23	23	23	23	23	23	23	23	23	23	23	23	23	23	23	23	23	23	23	23	26	26	23	23	23	23	23
32	32	32	32	32	32	32	32	32	32	32	32	32	32	32	32	32	32	32	32	32	32	32	32	32	32	32	32	32	32	32	34	38	39	39	39	39	39	23	23	23	23	23	23	23	23	23	23	23	23	23	23	23	23	23	23	23	23	23	23
