40
40
6  9  7  7  7  7  7  7  7  10 7  7  7  7  7  7  7  7  11 7  7  7  7  7  10 1  1  1  1  1  1  1  1  1  5  5  5  5  5  5
10 12 1  4  5  3  5  5  5  13 14 14 14 14 14 14 14 14 15 1  3  1  3  1  10 1  1  1  5  5  5  5  5  5  5  5  5  5  5  5
10 12 1  5  5  5  5  5  5  3  3  3  3  3  3  3  3  3  3  3  1  3  1  1  10 2  1  5  5  3  5  5  5  5  5  5  5  5  5  5
10 16 2  5  5  5  5  5  5  5  5  5  5  5  5  5  5  5  5  5  3  2  3  4  10 1  1  1  5  5  5  5  5  5  5  5  5  5  5  5
10 1  1  5  5  5  5  5  5  5  5  5  5  5  5  5  5  5  5  5  1  3  1  4  10 20 1  2  5  2  1  3  3  5  5  5  5  5  5  5
10 1  5  5  5  5  5  5  5  1  1  1  2  1  1  1  8  1  5  5  1  1  1  4  10 1  1  2  5  2  1  1  3  3  3  5  5  5  5  5
10 3  5  1  5  5  5  5  5  1  2  2  1  1  3  1  11 1  5  5  5  5  1  4  10 2  1  2  5  5  2  1  1  1  3  3  3  3  5  11
10 1  5  3  1  1  9  4  5  1  1  1  1  1  1  14 14 1  4  3  5  5  2  4  10 3  1  2  2  5  5  2  1  2  1  1  1  3  3  11
10 4  5  3  1  3  12 4  5  3  1  1  3  1  11 1  1  1  4  4  5  5  2  4  10 3  1  1  1  2  5  5  5  5  4  4  4  4  4  11
10 5  5  1  1  3  12 4  5  3  1  1  1  1  11 1  3  3  4  4  5  5  2  4  10 3  1  1  1  2  5  5  5  5  5  5  5  3  4  11
10 5  2  1  1  3  12 4  5  4  4  14 14 14 15 1  1  1  4  3  5  5  5  4  13 3  3  3  3  3  3  11 1  5  5  5  5  3  4  11
10 5  1  1  5  5  12 4  5  4  4  4  4  4  1  1  1  1  4  5  5  5  5  4  4  13 14 14 14 14 14 15 1  2  2  2  5  3  4  11
10 5  1  1  5  5  12 4  5  4  4  10 2  2  2  2  1  1  5  5  5  5  5  4  4  4  4  4  4  4  1  1  2  2  2  2  5  3  4  11
10 5  5  5  5  5  12 4  5  4  4  10 2  2  2  2  1  1  5  5  5  5  5  5  5  5  5  5  5  5  2  2  2  2  2  5  5  3  4  11
10 5  3  1  5  5  12 4  5  4  4  10 1  1  1  1  1  1  1  5  5  5  5  1  1  1  1  1  1  1  5  5  5  5  5  5  3  3  4  11
10 5  4  4  4  4  12 4  5  4  4  7  7  7  7  7  7  8  1  1  1  5  1  1  1  1  3  1  1  4  5  5  5  5  5  5  3  1  2  11
10 5  2  1  1  1  12 4  5  1  1  3  1  1  1  1  1  11 1  1  1  5  1  1  1  20 2  1  1  1  5  5  5  5  5  5  3  1  1  11
10 5  1  1  1  1  12 5  5  5  5  5  5  5  5  5  5  11 1  1  1  5  1  3  1  1  1  1  20 1  1  1  5  5  5  5  3  1  20 11
10 5  1  3  1  1  12 5  5  1  1  1  3  1  1  5  5  11 1  1  1  5  1  1  1  3  1  1  1  3  3  1  3  3  5  5  3  1  1  11
10 5  1  1  1  1  12 5  5  1  1  1  10 1  1  1  1  11 1  1  1  5  1  1  1  1  1  1  3  1  1  1  1  3  3  3  3  1  1  11
10 5  1  1  3  1  12 5  5  1  1  1  10 1  1  1  1  14 18 18 19 5  5  17 18 18 18 18 14 14 1  2  1  1  1  2  1  1  2  11
10 5  2  1  1  1  12 5  5  5  1  1  10 1  3  1  11 1  1  10 1  1  5  3  3  3  3  3  3  3  10 1  4  1  1  1  2  1  1  11
10 5  4  4  1  1  12 1  1  5  5  1  13 14 14 14 15 1  1  10 1  3  5  3  3  3  3  3  3  3  13 18 18 18 18 18 18 18 18 18
10 5  5  5  5  1  12 1  1  1  5  5  5  4  4  4  1  1  1  10 1  3  5  5  5  5  5  5  5  3  3  3  3  3  3  3  3  3  3  11
10 2  5  5  5  1  12 1  1  1  1  5  5  1  1  1  1  3  1  10 1  1  5  5  5  5  5  5  5  5  3  3  3  3  3  3  3  3  3  11
10 2  1  5  5  1  16 1  3  1  1  1  5  5  3  1  1  1  1  10 1  1  5  5  5  5  5  1  1  5  5  3  3  3  3  3  3  3  3  11
10 1  1  5  5  1  1  1  1  1  3  1  5  5  3  1  3  1  1  10 1  1  1  1  1  1  1  1  1  1  5  5  3  3  5  5  3  3  3  11
10 1  1  5  5  5  5  5  5  5  5  5  5  5  3  1  1  1  1  10 1  1  2  2  1  1  1  1  1  1  5  5  3  5  5  5  5  5  3  11
10 3  1  5  5  5  1  11 4  1  1  1  5  5  3  1  1  1  1  13 14 14 14 14 14 14 14 2  2  1  1  5  5  5  5  5  5  5  3  11
10 1  2  5  5  5  1  11 1  1  1  1  5  5  3  1  1  2  1  3  3  3  3  3  3  3  3  3  3  3  3  3  3  5  5  5  5  5  3  11
10 1  2  5  5  5  1  11 1  20 1  1  5  5  1  1  20 1  1  3  3  3  3  3  3  3  3  3  3  3  3  3  3  3  5  5  5  3  3  11
10 1  1  5  5  1  1  11 1  1  1  2  5  5  1  1  1  1  1  3  3  3  3  3  3  3  3  1  2  2  1  1  3  3  3  3  3  3  3  11
10 1  3  1  1  4  1  11 1  1  1  1  5  5  1  1  2  1  1  3  3  3  3  3  3  3  3  1  1  1  1  1  1  1  1  1  1  1  1  11
10 1  1  14 14 14 14 16 1  1  5  5  5  5  5  5  5  5  5  5  5  5  5  5  5  5  5  5  5  5  5  21 28 27 27 27 27 27 27 27
10 1  1  1  1  1  1  1  1  1  5  5  5  5  5  5  5  5  5  5  5  5  5  5  5  5  5  5  5  5  5  21 22 23 23 23 23 23 23 23
18 18 18 18 18 19 5  5  5  5  5  1  10 3  1  1  1  1  2  1  1  1  1  1  1  1  1  2  1  5  5  21 22 23 23 23 23 23 23 23
10 1  1  2  1  1  5  5  5  5  5  2  13 14 14 14 14 14 14 14 14 14 14 14 14 14 14 14 15 5  5  21 25 25 25 25 25 25 25 23
10 2  1	 5  5  5  5  1  3  1  1  1  4  4  4  4  4  4  4  4  4  4  4  4  4  4  1  1  1  5  5  21 22 23 23 24 24 24 24 23
10 1  2	 5  5  1  1  1  1  3  1  1  2  2  2  2  2  2  4  4  4  4  4  4  4  4  4  1  1  1  1  21 22 23 23 24 24 24 24 23
13 14 14 14 14 14 14 14 14 14 14 14 14 14 14 14 14 14 14 14 14 14 14 14 14 14 14 14 14 14 14 21 22 23 23 26 26 26 26 23